-21
26
-11
14
000000000000000000000000000000000000000000000000
111111111111111111111111111111111111111111111110
000000000000000000000000000000000000000000000000
000000000000000000000000000000000000000000000000
000000000000000000000000000000000000000000000000
000000000000000000000000000000000000000000000000
000000000000000000000000000000000000000000000000
000000000000000000000000000000000000000000000000
000000000000000000000000000000000000000000000000
000000000000000000000000000000000000000000000000
000000000000000000000000000011111011111110000000
000000000000000000000000000010000000000000000000
000000000000000000000000000010000000011111110000
000000000000000000000000000000000000011111110000
000000000000000000000000000000000000011111110000
000000000000000000000000000000000000011111110000
000000000000000000000000000000000000011111110000
000000000000000000000000000000000000011111110000
000000000000000000000000000000000000011111110000
000000000000000000000000000000000000000000000000
000000000000000000000000000000000000000000000000
000000000000000000000000000000000000000000000000
000000000000000000000000000000000000000000000000
000000000000000000000000000000000000000000000000
000000000000000000000000000000000000000000000000
000000000000000000000000000000000000000000000000
